##E############################
#     #                    #  #
#  ####  #############  ####  #
#        #     #  #  #        #
#  #######  #  #  #  #  ####  #
#  #  #     #  #  #     #     #
####  #  #######  #  ##########
#  #  #           #  #        #
#  #  ####  #######  ####  ####
#  #           #              #
#  #######  ####  ####  ####  #
#                 #        #  #
#######  #  ####  ##########  #
#        #     #     #  #  #  #
#  #  ####  ####  #  #  #  #  #
#  #  #  #     #  #  #     #  #
#  ####  ####  ####  #  #######
#     #     #     #     #     #
####  #  #######  ####  ####  #
#     #           #           #
############################^##